 NO          ./path_to_the_north_texture
WE ./path_to_the_south_texture 
SO ./path_to_the_west_texture
EA ./path_to_the_east_texture
F 220,100,0
C 	225,30,4294967296


            

111111111111111111111111
1000000000110000000000001
1011000001110000000000001
100100000000000000000000111111111
111111111011000001110000000000001
111111111111111111111111111111111
11111111111111111111111111111
111101111111110N11101010010001
11000000110101011100000010001
10000000000000001100000010001
10000000000000001101010010001
1100000111010101111101111000111
11110111 1110101 101111010001
11111111 1111111 111111111111