NO ./texture/wall.xpm
SO ./texture/wall.xpm
WE ./texture/wall.xpm
EA  ./texture/wall.xpm

F   255,255,255
C 	169,234,254

                 111111111
             11110000111
 11111111111111111000011111
10000111111100000000000111111111
1000000000110000000S000000000001
10110000011100000000000000000001
100100000000000000000000111111111111111111
111111111110000000000000000000000000011111
1111101110110000011100000000000000000000001
11111011111111111111D111111111111111111111
11111011111111111111011111111
11110011111111011101000000001
11000000110101011100000000001
10000000000000001100000000001
10000000000000001100000000001
10000000000000001100000000001
1000000000000000000000000001
10000000000000001100000000001
10000000000000001100000000001
1000000000000000110101010001
1100000111010101111101111000111
11110111 1110101 101111010001
11111111 1111111 111111111111